type octile
height 6
width 8
map
@@@@@@@@
@......@
@..@@..@
@..@@..@
@......@
@@@@@@@@